10 10 
P . . . . . . . . S 
. . . . . . . . . S
. . . . . . . . . S
. . . . . . . . . S
. . . . . . . . . S
. . . . . . . . . S
. . . . . . . . . S
. . . . . . . . . S
. . . . . . M M M S
S S S S S S S S S S

