10 10 
S S S S S S S S S S 
S P . . . . . . . S
S . . . . . . . . S
S . . . . . . . . S
S . . . . . . . . S
S . . . . . . . . S
S . . . . . . . . S
S . . . . . . . . S
S . . . . . M M M S
S S S S S S S S S S
