10 10 
# # # # # # # # # # 
# P . . . . . . . .
# . . . . . . . . .
# . . . . . . . . .
# . . . . . . . . .
# . . . . . . . . .
# . . . . . . . . .
# . . . . . . . . .
# . . . . . . . . .
# . . . . . . M M M

